16.0706:30,Rakhine United,1,3,Sagaing United,4
15.0706:30,Ayeyawady United,3,2,Dagon,5
10.0706:30,Ispe FC,0,4,Yangon United,4
06.0706:30,Yadanarbon,1,1,Myawady,2
05.0706:30,Gospel for Asia FC,3,5,Sagaing United,8
05.0706:00,Yangon United,0,0,Shan United,0
03.0706:30,Kachin United,0,1,Dagon,1
03.0706:00,Hantharwady United,1,2,Ispe FC,3
02.0706:30,Ayeyawady United,2,2,Rakhine United,4
30.0606:30,Sagaing United,0,1,Shan United,1
29.0606:00,Myawady,1,1,Dagon,2
28.0606:30,Yadanarbon,1,1,Ispe FC,2
27.0606:30,Ayeyawady United,5,3,Kachin United,8
27.0606:00,Yangon United,2,0,Hantharwady United,2
26.0606:00,Gospel for Asia FC,0,2,Rakhine United,2
24.0606:30,Shan United,3,2,Yadanarbon,5
23.0606:30,Sagaing United,1,3,Myawady,4
22.0606:30,Hantharwady United,1,0,Ayeyawady United,1
22.0606:00,Rakhine United,0,0,Kachin United,0
21.0606:00,Dagon,3,1,Gospel for Asia FC,4
09.0606:15,Hantharwady United,1,3,Yadanarbon,4
08.0606:15,Ispe FC,3,0,Sagaing United,3
07.0606:15,Rakhine United,1,2,Myawady,3
06.0606:15,Dagon,2,3,Shan United,5
05.0606:15,Kachin United,2,0,Gospel for Asia FC,2
04.0606:15,Yangon United,4,1,Ayeyawady United,5
02.0606:30,Dagon,2,3,Ispe FC,5
02.0606:15,Shan United,3,0,Rakhine United,3
01.0606:30,Sagaing United,3,2,Hantharwady United,5
01.0606:15,Myawady,1,3,Kachin United,4
31.0506:30,Yadanarbon,0,3,Yangon United,3
31.0506:15,Ayeyawady United,4,1,Gospel for Asia FC,5
28.0506:30,Rakhine United,1,1,Ispe FC,2
27.0506:30,Kachin United,0,0,Shan United,0
26.0506:30,Hantharwady United,1,0,Dagon,1
26.0506:15,Yangon United,4,0,Sagaing United,4
25.0506:30,Gospel for Asia FC,1,1,Myawady,2
25.0506:15,Yadanarbon,3,0,Ayeyawady United,3
18.0306:30,Kachin United,0,3,Hantharwady United,3
17.0306:30,Gospel for Asia FC,2,1,Ispe FC,3
16.0306:30,Yadanarbon,2,1,Dagon,3
16.0306:15,Yangon United,1,2,Rakhine United,3
15.0306:30,Myawady,1,4,Shan United,5
15.0306:15,Sagaing United,2,1,Ayeyawady United,3
12.0306:30,Rakhine United,0,1,Hantharwady United,1
11.0306:30,Dagon,0,1,Yangon United,1
10.0306:30,Ispe FC,4,0,Kachin United,4
10.0306:15,Shan United,5,1,Gospel for Asia FC,6
09.0306:30,Ayeyawady United,2,3,Myawady,5
09.0306:15,Sagaing United,0,0,Yadanarbon,0
06.0306:30,Kachin United,0,1,Yangon United,1
06.0306:15,Hantharwady United,4,1,Gospel for Asia FC,5
05.0306:30,Rakhine United,2,1,Yadanarbon,3
04.0306:30,Ispe FC,2,0,Myawady,2
03.0306:30,Ayeyawady United,1,3,Shan United,4
03.0306:15,Dagon,4,0,Sagaing United,4
28.0206:30,Gospel for Asia FC,2,1,Yadanarbon,3
28.0206:15,Kachin United,0,2,Sagaing United,2
27.0206:30,Hantharwady United,1,2,Shan United,3
27.0206:15,Yangon United,3,1,Myawady,4
26.0206:30,Rakhine United,3,4,Dagon,7
25.0206:30,Ayeyawady United,0,2,Ispe FC,2
23.0206:30,Gospel for Asia FC,0,5,Yangon United,5
23.0206:00,Myawady,1,1,Hantharwady United,2
22.0206:30,Sagaing United,0,0,Rakhine United,0
22.0206:00,Yadanarbon,0,0,Kachin United,0
21.0206:30,Dagon,2,2,Ayeyawady United,4
21.0206:00,Shan United,2,0,Ispe FC,2
16.1106:00,Shan United,1,0,Ispe FC,1
15.1106:00,Yangon United,0,0,Ayeyawady United,0
14.1106:00,Rakhine United,0,3,Myawady,3
12.1106:00,Yadanarbon,2,1,Hantharwady United,3
09.1106:00,Rakhine United,0,0,Ayeyawady United,0
08.1106:00,Ispe FC,0,0,Myawady,0
07.1106:00,Yadanarbon,2,4,Yangon United,6
06.1106:00,Gospel for Asia FC,0,2,Shan United,2
03.1106:00,Shan United,2,0,Hantharwady United,2
02.1106:00,Gospel for Asia FC,0,2,Yangon United,2
31.1006:00,Sagaing United,1,3,Rakhine United,4
30.1006:00,Myawady,2,1,Ayeyawady United,3
29.1006:00,Ispe FC,2,1,Yadanarbon,3
27.1006:00,Rakhine United,0,2,Shan United,2
26.1006:00,Hantharwady United,3,1,Myawady,4
24.1006:00,Ayeyawady United,5,3,Gospel for Asia FC,8
23.1006:00,Yadanarbon,0,0,Sagaing United,0
22.1006:00,Yangon United,3,0,Ispe FC,3
20.1006:00,Gospel for Asia FC,2,2,Rakhine United,4
19.1006:00,Myawady,0,1,Yadanarbon,1
17.1006:00,Ispe FC,2,2,Sagaing United,4
16.1006:00,Hantharwady United,1,0,Yangon United,1
15.1006:00,Ayeyawady United,1,2,Shan United,3
13.1006:00,Yadanarbon,1,0,Gospel for Asia FC,1
12.1006:00,Yangon United,1,0,Myawady,1
10.1006:00,Ayeyawady United,0,2,Hantharwady United,2
09.1006:00,Rakhine United,1,4,Ispe FC,5
08.1006:00,Shan United,2,0,Sagaing United,2
06.1006:00,Myawady,5,1,Gospel for Asia FC,6
05.1006:00,Hantharwady United,3,1,Ispe FC,4
03.1006:00,Ayeyawady United,6,1,Sagaing United,7
02.1006:00,Yangon United,10,0,Rakhine United,10
01.1006:00,Yadanarbon,1,1,Shan United,2
24.0906:00,Sagaing United,1,2,Gospel for Asia FC,3
19.0906:00,Sagaing United,0,3,Hantharwady United,3
15.0906:00,Myawady,2,1,Sagaing United,3
14.0906:00,Ayeyawady United,2,1,Yadanarbon,3
12.0906:00,Gospel for Asia FC,1,3,Ispe FC,4
11.0906:00,Hantharwady United,1,0,Rakhine United,1
10.0906:00,Yangon United,0,0,Shan United,0
08.0906:00,Ispe FC,0,2,Ayeyawady United,2
07.0906:00,Gospel for Asia FC,0,1,Hantharwady United,1
05.0906:00,Sagaing United,0,3,Yangon United,3
04.0906:00,Rakhine United,2,4,Yadanarbon,6
03.0906:00,Shan United,1,0,Myawady,1
25.0805:30,Yadanarbon,3,1,Ispe FC,4
24.0805:30,Yangon United,2,0,Gospel for Asia FC,2
22.0805:30,Rakhine United,1,2,Sagaing United,3
21.0805:30,Ayeyawady United,1,3,Myawady,4
20.0805:30,Hantharwady United,2,2,Shan United,4
18.0805:30,Rakhine United,1,2,Gospel for Asia FC,3
17.0805:30,Yadanarbon,2,0,Myawady,2
15.0805:30,Sagaing United,0,1,Ispe FC,1
14.0805:30,Yangon United,2,1,Hantharwady United,3
13.0805:30,Shan United,1,0,Ayeyawady United,1
11.0805:30,Ispe FC,5,1,Gospel for Asia FC,6
10.0805:30,Rakhine United,1,3,Hantharwady United,4
08.0805:30,Sagaing United,0,4,Myawady,4
07.0805:30,Yadanarbon,0,0,Ayeyawady United,0
06.0805:30,Shan United,1,0,Yangon United,1
04.0805:30,Myawady,1,0,Hantharwady United,1
03.0805:30,Sagaing United,2,1,Yadanarbon,3
01.0805:30,Shan United,2,0,Rakhine United,2
31.0705:30,Ispe FC,0,0,Yangon United,0
