17.0604:00,Armadale,4,0,Perth Glory u21,4
17.0604:00,Floreat Athena,0,3,Olympic Kingsway,3
17.0604:00,Balcatta,4,2,Inglewood United,6
17.0604:00,Bayswater,1,1,Cockburn City,2
17.0604:00,Stirling Macedonia,2,0,Perth RedStar,2
17.0604:00,Sorrento,2,3,Perth SC,5
10.0604:00,Inglewood United,0,1,Floreat Athena,1
10.0604:00,Perth Glory u21,1,3,Balcatta,4
10.0604:00,Perth RedStar,3,1,Perth SC,4
10.0604:00,Sorrento,5,2,Bayswater,7
10.0604:00,Cockburn City,0,4,Armadale,4
03.0604:00,Perth SC,6,1,Bayswater,7
03.0604:00,Cockburn City,2,2,Balcatta,4
03.0604:00,Perth RedStar,6,1,Olympic Kingsway,7
03.0604:00,Armadale,2,3,Sorrento,5
02.0608:00,Perth Glory u21,1,3,Floreat Athena,4
27.0507:00,Olympic Kingsway,4,3,Bayswater,7
27.0504:00,Perth RedStar,5,1,Cockburn City,6
27.0504:00,Armadale,0,5,Stirling Macedonia,5
27.0504:00,Perth SC,4,0,Inglewood United,4
27.0504:00,Balcatta,0,0,Floreat Athena,0
20.0504:00,Perth SC,3,4,Armadale,7
20.0504:00,Stirling Macedonia,3,0,Perth Glory u21,3
20.0504:00,Floreat Athena,1,2,Cockburn City,3
20.0504:00,Bayswater,1,1,Perth RedStar,2
20.0504:00,Olympic Kingsway,0,4,Inglewood United,4
13.0504:00,Perth SC,1,2,Balcatta,3
13.0504:00,Bayswater,2,1,Armadale,3
13.0504:00,Olympic Kingsway,2,1,Perth Glory u21,3
13.0504:00,Sorrento,3,1,Floreat Athena,4
06.0504:00,Cockburn City,1,1,Inglewood United,2
06.0504:00,Sorrento,0,2,Olympic Kingsway,2
06.0504:00,Perth RedStar,1,2,Perth Glory u21,3
06.0504:00,Armadale,5,3,Balcatta,8
06.0504:00,Perth SC,0,4,Stirling Macedonia,4
06.0504:00,Bayswater,2,0,Floreat Athena,2
29.0408:00,Stirling Macedonia,1,3,Bayswater,4
29.0404:00,Olympic Kingsway,5,0,Perth SC,5
29.0404:00,Perth Glory u21,5,4,Cockburn City,9
29.0404:00,Balcatta,0,3,Perth RedStar,3
29.0404:00,Floreat Athena,0,3,Armadale,3
29.0404:00,Inglewood United,1,1,Sorrento,2
15.0404:00,Inglewood United,4,3,Perth Glory u21,7
15.0404:00,Armadale,1,6,Perth RedStar,7
15.0404:00,Olympic Kingsway,1,3,Cockburn City,4
15.0404:00,Perth SC,2,1,Floreat Athena,3
15.0404:00,Sorrento,1,2,Stirling Macedonia,3
15.0404:00,Balcatta,0,2,Bayswater,2
08.0404:00,Stirling Macedonia,1,2,Balcatta,3
08.0404:00,Perth RedStar,0,2,Floreat Athena,2
08.0404:00,Olympic Kingsway,2,1,Armadale,3
08.0404:00,Inglewood United,1,3,Bayswater,4
08.0404:00,Perth SC,2,1,Perth Glory u21,3
08.0404:00,Cockburn City,0,3,Sorrento,3
01.0406:00,Floreat Athena,2,1,Stirling Macedonia,3
01.0404:30,Sorrento,1,7,Perth RedStar,8
01.0404:00,Perth SC,0,1,Cockburn City,1
01.0404:00,Olympic Kingsway,2,3,Balcatta,5
01.0404:00,Armadale,4,0,Inglewood United,4
01.0404:00,Bayswater,3,3,Perth Glory u21,6
25.0308:00,Olympic Kingsway,0,2,Floreat Athena,2
25.0304:00,Inglewood United,1,2,Balcatta,3
25.0304:00,Cockburn City,2,1,Bayswater,3
25.0304:00,Perth Glory u21,4,3,Armadale,7
25.0304:00,Perth RedStar,1,2,Stirling Macedonia,3
25.0304:00,Perth SC,1,0,Sorrento,1
18.0308:00,Stirling Macedonia,2,1,Olympic Kingsway,3
18.0306:00,Floreat Athena,2,3,Inglewood United,5
18.0304:00,Armadale,6,1,Cockburn City,7
18.0304:00,Perth SC,1,1,Perth RedStar,2
18.0304:00,Balcatta,1,2,Perth Glory u21,3
17.0308:00,Bayswater,1,4,Sorrento,5
27.0804:00,Armadale,2,3,Floreat Athena,5
27.0804:00,Perth RedStar,3,0,Cockburn City,3
27.0804:00,Bayswater,0,1,Balcatta,1
27.0804:00,Inglewood United,1,0,Perth SC,1
27.0804:00,Stirling Macedonia,1,2,Sorrento,3
27.0804:00,Perth Glory u21,4,0,Gwelup Croatia,4
23.0808:00,Sorrento,2,1,Inglewood United,3
20.0804:00,Gwelup Croatia,0,3,Balcatta,3
20.0804:00,Cockburn City,1,4,Perth Glory u21,5
20.0804:00,Floreat Athena,0,0,Stirling Macedonia,0
20.0804:00,Bayswater,2,1,Perth SC,3
20.0804:00,Inglewood United,0,1,Armadale,1
20.0804:00,Sorrento,5,2,Perth RedStar,7
16.0808:30,Armadale,3,5,Bayswater,8
15.0808:30,Perth Glory u21,3,4,Perth RedStar,7
13.0806:00,Perth SC,2,0,Gwelup Croatia,2
13.0804:00,Floreat Athena,3,1,Sorrento,4
13.0804:00,Balcatta,0,3,Cockburn City,3
13.0804:00,Stirling Macedonia,1,0,Inglewood United,1
06.0804:00,Perth SC,3,3,Cockburn City,6
06.0804:00,Gwelup Croatia,2,2,Armadale,4
06.0804:00,Perth RedStar,5,1,Balcatta,6
06.0804:00,Bayswater,1,3,Stirling Macedonia,4
06.0804:00,Inglewood United,0,1,Floreat Athena,1
05.0808:30,Perth Glory u21,1,5,Sorrento,6
30.0706:00,Perth SC,0,4,Perth RedStar,4
30.0704:00,Armadale,3,0,Cockburn City,3
30.0704:00,Floreat Athena,3,3,Bayswater,6
30.0704:00,Balcatta,3,0,Perth Glory u21,3
30.0704:00,Inglewood United,0,2,Sorrento,2
30.0704:00,Stirling Macedonia,3,1,Gwelup Croatia,4
26.0708:00,Balcatta,0,1,Perth SC,1
23.0702:00,Perth RedStar,2,0,Perth SC,2
23.0702:00,Balcatta,0,0,Gwelup Croatia,0
16.0704:00,Gwelup Croatia,1,4,Floreat Athena,5
16.0704:00,Cockburn City,3,0,Stirling Macedonia,3
16.0704:00,Perth SC,0,2,Perth Glory u21,2
16.0704:00,Perth RedStar,5,1,Armadale,6
16.0704:00,Bayswater,1,1,Inglewood United,2
16.0704:00,Sorrento,1,1,Balcatta,2
09.0704:00,Armadale,1,5,Perth Glory u21,6
09.0704:00,Perth SC,3,0,Balcatta,3
09.0704:00,Floreat Athena,3,3,Cockburn City,6
09.0704:00,Bayswater,4,2,Sorrento,6
09.0704:00,Inglewood United,3,2,Gwelup Croatia,5
09.0704:00,Stirling Macedonia,2,1,Perth RedStar,3
05.0708:30,Stirling Macedonia,1,0,Cockburn City,1
02.0704:00,Gwelup Croatia,2,3,Bayswater,5
02.0704:00,Cockburn City,1,2,Inglewood United,3
02.0704:00,Perth RedStar,2,3,Floreat Athena,5
02.0704:00,Balcatta,1,3,Armadale,4
02.0704:00,Sorrento,1,1,Perth SC,2
01.0708:30,Perth Glory u21,0,1,Stirling Macedonia,1
25.0606:00,Stirling Macedonia,0,0,Balcatta,0
25.0604:00,Armadale,0,5,Perth SC,5
25.0604:00,Gwelup Croatia,1,4,Sorrento,5
25.0604:00,Floreat Athena,4,0,Perth Glory u21,4
25.0604:00,Bayswater,1,1,Cockburn City,2
25.0604:00,Inglewood United,1,0,Perth RedStar,1
