23.0604:30,Western Springs,3,1,Bay Olympic,4
23.0604:00,Christchurch United,2,0,Coastal Spirit,2
21.0604:00,Wellington Phoenix II,3,1,Miramar,4
14.0604:30,Manukau United,0,5,Auckland City,5
10.0623:00,Napier City Rovers,4,1,StopOutSC,5
10.0623:00,Western Suburbs,2,0,North Wellington,2
10.0621:00,Coastal Spirit,1,3,Ferrymead Bays,4
10.0621:00,NelsonSuburbs,7,1,Selwyn United,8
10.0603:00,Bay Olympic,0,1,Auckland City,1
10.0600:30,Petone,2,0,Whanganui Athletic FC,2
10.0600:00,Eastern Suburbs,2,0,Western Springs,2
10.0600:00,West Coast Rangers,0,4,Manurewa AFC,4
10.0600:00,Melville United,1,1,Takapuna AFC,2
10.0600:00,Auckland United,4,0,Hamilton Wanderers,4
09.0623:45,Cashmere Technical,6,1,FCTwenty11,7
09.0623:30,Waterside Karori,1,3,Wellington Phoenix II,4
09.0623:30,Miramar,0,7,Wellington Olympic,7
03.0600:00,Takapuna AFC,3,4,Auckland United,7
03.0600:00,Eastern Suburbs,2,1,Melville United,3
03.0600:00,Hamilton Wanderers,3,2,West Coast Rangers,5
03.0600:00,Manukau United,3,3,Bay Olympic,6
03.0600:00,Manurewa AFC,1,3,Birkenhead United,4
02.0604:30,Western Springs,1,3,Auckland City,4
27.0523:00,Western Suburbs,2,5,Wellington Olympic,7
27.0523:00,Napier City Rovers,3,1,North Wellington,4
27.0522:30,Coastal Spirit,1,0,South City Royals,1
27.0502:30,Hamilton Wanderers,2,2,Birkenhead United,4
27.0500:00,Melville United,2,1,Western Springs,3
27.0500:00,Manurewa AFC,1,0,Bay Olympic,1
27.0500:00,Auckland United,0,1,Eastern Suburbs,1
27.0500:00,Takapuna AFC,2,1,West Coast Rangers,3
27.0500:00,Waterside Karori,3,1,Whanganui Athletic FC,4
26.0523:45,Nomads United,3,1,Selwyn United,4
26.0523:45,Cashmere Technical,1,1,Christchurch United,2
26.0521:00,Green Island,1,2,Ferrymead Bays,3
26.0520:30,FCTwenty11,0,6,NelsonSuburbs,6
20.0521:00,NelsonSuburbs,1,1,Nomads United,2
20.0502:30,Bay Olympic,1,3,Hamilton Wanderers,4
20.0500:30,Petone,2,2,Waterside Karori,4
20.0500:00,West Coast Rangers,1,2,Eastern Suburbs,3
20.0500:00,Western Springs,3,2,Manukau United,5
20.0500:00,North Wellington,3,3,StopOutSC,6
19.0523:45,South City Royals,4,2,Green Island,6
19.0523:30,Whanganui Athletic FC,0,2,Miramar,2
19.0522:45,Wellington Olympic,6,3,Napier City Rovers,9
19.0504:15,Ferrymead Bays,2,6,Cashmere Technical,8
19.0504:00,Christchurch United,1,0,FCTwenty11,1
19.0504:00,Selwyn United,2,3,Coastal Spirit,5
13.0502:30,Melville United,3,1,West Coast Rangers,4
13.0500:00,Auckland United,1,1,Western Springs,2
13.0500:00,Manurewa AFC,3,0,Manukau United,3
13.0500:00,Takapuna AFC,1,2,Bay Olympic,3
13.0500:00,Eastern Suburbs,2,0,Birkenhead United,2
06.0523:00,Western Suburbs,7,1,Whanganui Athletic FC,8
06.0523:00,Napier City Rovers,2,3,Wellington Phoenix II,5
06.0521:00,Coastal Spirit,2,1,Nomads United,3
06.0503:00,Bay Olympic,2,4,Eastern Suburbs,6
06.0500:00,West Coast Rangers,1,0,Auckland United,1
06.0500:00,Auckland City,4,0,Takapuna AFC,4
06.0500:00,Manukau United,2,2,Hamilton Wanderers,4
06.0500:00,North Wellington,0,5,Petone,5
05.0523:45,FCTwenty11,3,0,Ferrymead Bays,3
05.0523:30,StopOutSC,3,2,Wellington Olympic,5
05.0523:30,Miramar,3,4,Waterside Karori,7
05.0522:30,Cashmere Technical,2,3,South City Royals,5
05.0521:00,Green Island,4,1,Selwyn United,5
05.0520:30,Christchurch United,4,0,NelsonSuburbs,4
05.0504:30,Western Springs,1,3,Manurewa AFC,4
03.0504:00,Wellington Phoenix II,0,1,Western Suburbs,1
30.0402:00,Western Springs,0,1,West Coast Rangers,1
29.0421:00,NelsonSuburbs,5,0,Coastal Spirit,5
29.0402:30,Melville United,3,2,Bay Olympic,5
29.0400:45,Wellington Olympic,7,0,North Wellington,7
29.0400:30,Petone,4,3,Miramar,7
29.0400:00,Hamilton Wanderers,3,3,Manurewa AFC,6
29.0400:00,Eastern Suburbs,0,0,Auckland City,0
29.0400:00,Takapuna AFC,2,2,Manukau United,4
29.0400:00,Auckland United,3,3,Birkenhead United,6
29.0400:00,Wellington Phoenix II,2,0,StopOutSC,2
28.0423:45,Ferrymead Bays,0,6,Christchurch United,6
28.0423:30,Waterside Karori,2,2,Western Suburbs,4
28.0423:30,Whanganui Athletic FC,1,5,Napier City Rovers,6
28.0421:00,South City Royals,3,0,FCTwenty11,3
28.0420:00,Nomads United,6,2,Green Island,8
28.0404:00,Selwyn United,1,2,Cashmere Technical,3
22.0423:00,Napier City Rovers,5,0,Waterside Karori,5
22.0423:00,Western Suburbs,3,1,Miramar,4
22.0422:50,NelsonSuburbs,1,1,South City Royals,2
22.0403:00,Bay Olympic,1,2,Auckland United,3
22.0400:45,Wellington Olympic,4,2,Petone,6
22.0400:00,Auckland City,3,1,Melville United,4
22.0400:00,Manurewa AFC,0,0,Takapuna AFC,0
22.0400:00,Manukau United,0,6,Eastern Suburbs,6
22.0400:00,Western Springs,3,1,Hamilton Wanderers,4
22.0400:00,Birkenhead United,2,0,West Coast Rangers,2
22.0400:00,North Wellington,0,4,Wellington Phoenix II,4
22.0400:00,StopOutSC,3,1,Whanganui Athletic FC,4
21.0423:45,Ferrymead Bays,1,0,Selwyn United,1
21.0423:45,FCTwenty11,1,4,Coastal Spirit,5
21.0422:30,Cashmere Technical,2,1,Green Island,3
21.0404:00,Christchurch United,1,0,Nomads United,1
15.0423:00,Napier City Rovers,2,2,Western Suburbs,4
15.0421:00,Coastal Spirit,1,1,Cashmere Technical,2
15.0400:45,Wellington Olympic,6,1,Whanganui Athletic FC,7
15.0400:00,Takapuna AFC,2,3,Hamilton Wanderers,5
15.0400:00,West Coast Rangers,2,1,Bay Olympic,3
15.0400:00,Melville United,1,0,Manukau United,1
15.0400:00,Eastern Suburbs,4,3,Manurewa AFC,7
15.0400:00,Auckland United,0,2,Auckland City,2
15.0400:00,Wellington Phoenix II,3,1,Petone,4
14.0423:45,Nomads United,0,2,FCTwenty11,2
14.0423:30,Miramar,3,0,StopOutSC,3
14.0423:30,North Wellington,1,4,Waterside Karori,5
14.0421:30,Green Island,3,4,NelsonSuburbs,7
14.0421:00,South City Royals,2,1,Ferrymead Bays,3
14.0404:00,Selwyn United,0,2,Christchurch United,2
10.0403:00,Bay Olympic,2,4,Birkenhead United,6
10.0400:00,Manukau United,1,4,Auckland United,5
10.0400:00,Western Springs,3,0,Takapuna AFC,3
10.0400:00,Hamilton Wanderers,1,1,Eastern Suburbs,2
10.0400:00,Manurewa AFC,5,0,Melville United,5
10.0400:00,Auckland City,1,1,West Coast Rangers,2
08.0423:00,Napier City Rovers,1,2,Miramar,3
08.0400:30,Petone,2,3,Western Suburbs,5
08.0400:00,Whanganui Athletic FC,0,5,North Wellington,5
07.0423:30,Waterside Karori,2,3,StopOutSC,5
07.0403:00,Bay Olympic,2,3,Western Springs,5
07.0400:00,Melville United,2,4,Hamilton Wanderers,6
07.0400:00,Auckland United,1,1,Manurewa AFC,2
07.0400:00,Eastern Suburbs,1,0,Takapuna AFC,1
07.0400:00,West Coast Rangers,1,3,Manukau United,4
07.0400:00,Wellington Phoenix II,1,2,Wellington Olympic,3
06.0423:45,FCTwenty11,0,1,Selwyn United,1
06.0423:45,Cashmere Technical,7,3,Nomads United,10
06.0423:00,Auckland City,5,1,Birkenhead United,6
06.0422:30,Christchurch United,5,2,South City Royals,7
06.0421:00,Green Island,0,1,Coastal Spirit,1
06.0420:30,Ferrymead Bays,1,1,NelsonSuburbs,2
01.0423:00,Whanganui Athletic FC,3,4,Wellington Phoenix II,7
01.0423:00,Western Suburbs,3,3,StopOutSC,6
01.0421:00,NelsonSuburbs,1,4,Cashmere Technical,5
01.0421:00,Coastal Spirit,0,4,Christchurch United,4
31.0323:00,Takapuna AFC,0,1,Melville United,1
31.0323:00,Manukau United,0,7,Birkenhead United,7
31.0323:00,Auckland City,5,1,Bay Olympic,6
31.0323:00,Manurewa AFC,5,1,West Coast Rangers,6
31.0323:00,Hamilton Wanderers,0,1,Auckland United,1
31.0322:45,Nomads United,1,2,Ferrymead Bays,3
31.0322:30,Miramar,3,0,North Wellington,3
31.0322:30,Waterside Karori,1,2,Wellington Olympic,3
31.0321:30,Selwyn United,0,5,South City Royals,5
31.0321:30,Petone,4,2,Napier City Rovers,6
31.0320:00,Green Island,2,0,FCTwenty11,2
31.0303:30,Western Springs,0,1,Eastern Suburbs,1
25.0323:00,Birkenhead United,2,4,Manurewa AFC,6
24.0323:45,Wellington Olympic,3,1,Miramar,4
24.0323:00,Auckland United,1,0,Takapuna AFC,1
24.0323:00,West Coast Rangers,3,1,Hamilton Wanderers,4
24.0323:00,Bay Olympic,3,2,Manukau United,5
24.0323:00,Auckland City,4,0,Western Springs,4
24.0323:00,Melville United,0,1,Eastern Suburbs,1
24.0323:00,Wellington Phoenix II,3,2,Waterside Karori,5
24.0323:00,North Wellington,1,3,Western Suburbs,4
24.0322:45,FCTwenty11,0,6,Cashmere Technical,6
24.0322:30,Whanganui Athletic FC,2,3,Petone,5
24.0322:30,StopOutSC,1,3,Napier City Rovers,4
24.0321:30,Christchurch United,3,0,Green Island,3
24.0320:00,South City Royals,3,0,Nomads United,3
24.0319:30,Selwyn United,4,1,NelsonSuburbs,5
24.0303:15,Ferrymead Bays,3,0,Coastal Spirit,3
26.1123:00,Miramar,1,4,Wellington Olympic,5
26.1121:00,Wellington Phoenix II,4,2,Birkenhead United,6
25.1123:00,Auckland City,2,0,Melville United,2
25.1121:00,Auckland United,3,2,Napier City Rovers,5
25.1103:00,Christchurch United,4,1,Cashmere Technical,5
20.1100:00,Cashmere Technical,1,3,Wellington Phoenix II,4
19.1123:00,Auckland City,2,1,Miramar,3
19.1100:00,Melville United,4,3,Napier City Rovers,7
18.1123:00,Birkenhead United,2,0,Auckland United,2
18.1122:00,Wellington Olympic,7,1,Christchurch United,8
12.1122:00,Napier City Rovers,1,1,Birkenhead United,2
12.1120:00,Wellington Phoenix II,1,1,Wellington Olympic,2
11.1123:30,Miramar,2,3,Melville United,5
11.1123:00,Auckland United,2,1,Cashmere Technical,3
11.1121:30,Christchurch United,2,3,Auckland City,5
05.1123:00,Melville United,2,0,Birkenhead United,2
05.1121:00,Miramar,0,3,Christchurch United,3
04.1123:00,Wellington Olympic,3,1,Auckland United,4
04.1121:00,Auckland City,2,0,Wellington Phoenix II,2
04.1120:00,Cashmere Technical,4,2,Napier City Rovers,6
29.1022:30,Christchurch United,2,5,Melville United,7
29.1022:00,Birkenhead United,5,3,Cashmere Technical,8
28.1023:00,Auckland United,3,2,Auckland City,5
28.1022:00,Wellington Phoenix II,2,3,Miramar,5
28.1021:00,Napier City Rovers,2,5,Wellington Olympic,7
22.1023:00,Auckland City,3,0,Napier City Rovers,3
22.1021:00,Miramar,0,1,Auckland United,1
21.1023:00,Christchurch United,1,3,Wellington Phoenix II,4
21.1022:00,Wellington Olympic,2,0,Birkenhead United,2
21.1021:00,Melville United,1,3,Cashmere Technical,4
15.1022:30,Cashmere Technical,0,3,Wellington Olympic,3
15.1020:00,Wellington Phoenix II,1,1,Melville United,2
15.1000:00,Auckland United,1,1,Christchurch United,2
14.1023:00,Napier City Rovers,2,2,Miramar,4
14.1022:00,Birkenhead United,2,2,Auckland City,4
08.1022:00,Melville United,0,4,Wellington Olympic,4
08.1020:00,Wellington Phoenix II,2,2,Auckland United,4
07.1023:30,Auckland City,2,0,Cashmere Technical,2
07.1021:00,Miramar,2,4,Birkenhead United,6
07.1020:30,Christchurch United,1,1,Napier City Rovers,2
01.1023:00,Auckland United,1,0,Melville United,1
01.1021:00,Birkenhead United,3,1,Christchurch United,4
30.0923:00,Wellington Olympic,1,2,Auckland City,3
30.0922:00,Napier City Rovers,1,0,Wellington Phoenix II,1
30.0921:00,Cashmere Technical,4,0,Miramar,4
23.0904:00,Wellington Olympic,1,0,Miramar,1
03.0900:00,Birkenhead United,2,1,Manukau United,3
03.0900:00,North Shore United,2,2,Eastern Suburbs,4
03.0900:00,Waiheke United AFC,0,3,Takapuna AFC,3
03.0900:00,Auckland United,2,0,Auckland City,2
03.0900:00,Western Springs,4,1,Bay Olympic,5
03.0900:00,Hamilton Wanderers,2,3,Melville United,5
02.0921:30,South City Royals,1,0,NelsonSuburbs,1
31.0804:30,Western Springs,3,5,Auckland City,8
27.0823:30,Miramar,2,1,Napier City Rovers,3
27.0823:30,Wellington Phoenix II,1,2,Wellington United FC,3
27.0823:30,Havelock North Wanderers,1,7,Wellington Olympic,8
27.0823:30,North Wellington,3,1,Petone,4
27.0823:30,Western Suburbs,1,4,Waterside Karori,5
27.0821:00,NelsonSuburbs,3,2,Selwyn United,5
27.0800:00,Takapuna AFC,4,4,Western Springs,8
27.0800:00,Hamilton Wanderers,1,2,Manukau United,3
27.0800:00,Waiheke United AFC,0,4,Birkenhead United,4
27.0800:00,Melville United,3,0,North Shore United,3
27.0800:00,Auckland United,5,0,Bay Olympic,5
26.0823:45,Coastal Spirit,0,2,Nomads United,2
26.0823:00,Ferrymead Bays,3,2,Green Island,5
26.0822:15,Christchurch United,10,0,Mosgiel,10
26.0822:15,South City Royals,4,5,Cashmere Technical,9
24.0804:00,Eastern Suburbs,1,4,Melville United,5
23.0804:30,Birkenhead United,2,0,Hamilton Wanderers,2
20.0823:00,Napier City Rovers,3,1,Western Suburbs,4
20.0800:00,North Shore United,0,6,Auckland United,6
20.0800:00,Bay Olympic,3,1,Waiheke United AFC,4
20.0800:00,Manukau United,3,2,Takapuna AFC,5
20.0800:00,Petone,2,0,Havelock North Wanderers,2
19.0823:45,Green Island,1,2,South City Royals,3
19.0823:45,Selwyn United,3,1,Ferrymead Bays,4
19.0823:45,Cashmere Technical,1,0,Christchurch United,1
19.0823:30,Wellington United FC,5,1,North Wellington,6
19.0821:30,Waterside Karori,1,0,Wellington Phoenix II,1
19.0821:30,Mosgiel,0,5,Coastal Spirit,5
19.0821:00,Nomads United,3,5,NelsonSuburbs,8
17.0804:00,Miramar,2,2,Waterside Karori,4
13.0823:30,Western Suburbs,1,11,Wellington Olympic,12
13.0823:00,Havelock North Wanderers,1,4,Wellington United FC,5
13.0800:00,Hamilton Wanderers,2,1,Bay Olympic,3
13.0800:00,Eastern Suburbs,0,0,Western Springs,0
13.0800:00,Takapuna AFC,2,4,Birkenhead United,6
13.0800:00,Waiheke United AFC,2,0,North Shore United,2
13.0800:00,Auckland United,2,0,Melville United,2
13.0800:00,Wellington Phoenix II,2,0,North Wellington,2
12.0823:45,Ferrymead Bays,4,2,Nomads United,6
12.0823:30,Waterside Karori,2,1,Napier City Rovers,3
12.0823:30,Miramar,5,1,Petone,6
12.0823:00,Christchurch United,9,1,Green Island,10
12.0821:30,Mosgiel,0,8,Cashmere Technical,8
12.0821:30,South City Royals,3,2,Selwyn United,5
12.0820:30,Coastal Spirit,1,1,NelsonSuburbs,2
09.0804:00,Christchurch United,1,0,Nomads United,1
06.0823:00,Napier City Rovers,2,0,Wellington Phoenix II,2
06.0821:00,NelsonSuburbs,3,2,Ferrymead Bays,5
06.0800:45,Wellington Olympic,2,0,Waterside Karori,2
06.0800:00,North Shore United,0,5,Hamilton Wanderers,5
06.0800:00,Manukau United,1,1,Eastern Suburbs,2
06.0800:00,Bay Olympic,1,2,Takapuna AFC,3
06.0800:00,Western Springs,3,2,Melville United,5
06.0800:00,Auckland United,7,0,Waiheke United AFC,7
06.0800:00,Petone,4,0,Western Suburbs,4
05.0823:45,Selwyn United,0,4,Christchurch United,4
05.0823:45,Green Island,5,1,Mosgiel,6
05.0823:45,Cashmere Technical,3,1,Coastal Spirit,4
05.0823:30,Wellington United FC,1,2,Miramar,3
05.0823:00,North Wellington,1,4,Havelock North Wanderers,5
05.0822:30,Nomads United,1,0,South City Royals,1
30.0700:00,Western Springs,4,3,Manukau United,7
23.0723:30,Western Suburbs,2,1,Wellington United FC,3
23.0723:00,Napier City Rovers,2,5,Wellington Olympic,7
23.0700:00,Melville United,4,1,Waiheke United AFC,5
23.0700:00,Takapuna AFC,0,1,North Shore United,1
23.0700:00,Hamilton Wanderers,3,5,Auckland United,8
23.0700:00,Auckland City,2,1,Bay Olympic,3
23.0700:00,Eastern Suburbs,1,3,Birkenhead United,4
23.0700:00,Wellington Phoenix II,4,0,Havelock North Wanderers,4
22.0723:45,Coastal Spirit,1,2,Ferrymead Bays,3
22.0723:30,Miramar,5,1,North Wellington,6
22.0723:30,Waterside Karori,1,1,Petone,2
22.0723:00,Cashmere Technical,8,0,Green Island,8
22.0721:30,Mosgiel,1,1,Selwyn United,2
19.0704:00,Auckland City,3,1,Manukau United,4
16.0723:00,Havelock North Wanderers,2,3,Miramar,5
16.0721:00,NelsonSuburbs,0,5,Christchurch United,5
16.0700:45,Wellington Olympic,0,3,Wellington Phoenix II,3
16.0700:00,Eastern Suburbs,1,0,Bay Olympic,1
16.0700:00,Manukau United,0,4,Melville United,4
16.0700:00,Auckland City,6,0,North Shore United,6
16.0700:00,Waiheke United AFC,1,2,Hamilton Wanderers,3
16.0700:00,Auckland United,3,3,Takapuna AFC,6
16.0700:00,Western Springs,1,1,Birkenhead United,2
16.0700:00,North Wellington,5,1,Western Suburbs,6
16.0700:00,Petone,2,2,Napier City Rovers,4
15.0723:45,Selwyn United,1,3,Cashmere Technical,4
15.0723:30,Wellington United FC,4,2,Waterside Karori,6
15.0723:00,Ferrymead Bays,1,3,South City Royals,4
15.0723:00,Nomads United,3,0,Mosgiel,3
15.0721:30,Green Island,4,3,Coastal Spirit,7
13.0704:00,Birkenhead United,3,5,Auckland City,8
02.0723:30,Western Suburbs,4,1,Havelock North Wanderers,5
02.0723:00,Napier City Rovers,4,0,Wellington United FC,4
02.0700:45,Wellington Olympic,5,0,Petone,5
02.0700:00,Waiheke United AFC,0,2,Auckland City,2
02.0700:00,Bay Olympic,2,4,Manukau United,6
02.0700:00,Eastern Suburbs,0,1,Auckland United,1
02.0700:00,Hamilton Wanderers,2,2,Takapuna AFC,4
02.0700:00,North Shore United,1,6,Western Springs,7
02.0700:00,Melville United,0,1,Birkenhead United,1
01.0723:45,Mosgiel,2,4,NelsonSuburbs,6
01.0723:45,Cashmere Technical,9,1,Nomads United,10
01.0723:30,Waterside Karori,1,2,North Wellington,3
01.0723:30,Miramar,2,1,Wellington Phoenix II,3
01.0723:00,Coastal Spirit,1,0,South City Royals,1
01.0721:30,Green Island,3,2,Selwyn United,5
01.0704:00,Christchurch United,0,0,Ferrymead Bays,0
29.0604:00,Auckland City,2,1,Eastern Suburbs,3
25.0623:00,Havelock North Wanderers,2,2,Waterside Karori,4
25.0600:00,Eastern Suburbs,2,1,Waiheke United AFC,3
25.0600:00,Manukau United,6,0,North Shore United,6
25.0600:00,Auckland City,2,0,Hamilton Wanderers,2
25.0600:00,Birkenhead United,3,0,Bay Olympic,3
