03.0713:00,Johor DT,6,1,Kuala Lumpur City,7
03.0713:00,Terengganu,1,0,Kedah,1
03.0713:00,Selangor,2,1,Kuching City FC,3
26.0613:00,Kelantan United,0,3,Sabah,3
26.0613:00,Negeri Sembilan,1,1,Palau Pinang,2
23.0613:00,Perak,1,2,PDRM FC,3
23.0613:00,Kelantan,0,5,Sri Pahang,5
09.0613:00,Terengganu,1,3,Johor DT,4
09.0612:15,Sri Pahang,4,3,Negeri Sembilan,7
08.0613:00,Palau Pinang,1,1,Kuala Lumpur City,2
08.0613:00,PDRM FC,1,0,Sabah,1
07.0613:00,Kelantan United,1,7,Selangor,8
07.0613:00,Kedah,3,0,Perak,3
04.0613:00,Sri Pahang,1,2,Kuala Lumpur City,3
04.0611:30,Kuching City FC,1,1,Negeri Sembilan,2
03.0613:00,Palau Pinang,0,2,Johor DT,2
03.0612:15,PDRM FC,1,0,Selangor,1
03.0609:30,Perak,0,3,Terengganu,3
02.0613:00,Kedah,2,1,Sabah,3
24.0513:00,Terengganu,1,0,Palau Pinang,1
24.0513:00,Selangor,3,2,Kedah,5
24.0513:00,Kuala Lumpur City,1,1,Kuching City FC,2
24.0512:15,Johor DT,2,0,Sri Pahang,2
23.0513:00,Negeri Sembilan,3,3,Kelantan United,6
23.0513:00,Kelantan,1,4,PDRM FC,5
23.0512:15,Sabah,3,1,Perak,4
20.0513:00,Kelantan United,1,3,Kuala Lumpur City,4
20.0512:15,Perak,0,4,Selangor,4
20.0509:15,Sri Pahang,1,0,Palau Pinang,1
19.0513:00,Kedah,5,0,Kelantan,5
19.0512:15,Kuching City FC,0,4,Johor DT,4
19.0511:30,Sabah,2,2,Terengganu,4
18.0512:15,PDRM FC,1,2,Negeri Sembilan,3
14.0513:00,Negeri Sembilan,2,1,Kuala Lumpur City,3
13.0512:15,Johor DT,6,0,Kelantan United,6
28.0413:00,Terengganu,1,2,Sri Pahang,3
28.0413:00,Kelantan,2,3,Perak,5
28.0412:15,Negeri Sembilan,1,2,Kedah,3
27.0413:00,Palau Pinang,2,1,Kuching City FC,3
27.0412:15,Kuala Lumpur City,3,0,PDRM FC,3
19.0414:00,PDRM FC,0,1,Johor DT,1
19.0414:00,Perak,1,1,Negeri Sembilan,2
19.0413:15,Sabah,6,1,Kelantan,7
18.0414:00,Kedah,2,3,Kuala Lumpur City,5
18.0414:00,Palau Pinang,2,0,Kelantan United,2
18.0414:00,Selangor,5,1,Terengganu,6
18.0413:15,Kuching City FC,0,1,Sri Pahang,1
10.0414:00,Sri Pahang,1,0,Kelantan United,1
10.0414:00,Kuala Lumpur City,1,0,Perak,1
10.0414:00,Negeri Sembilan,1,1,Sabah,2
09.0414:00,Terengganu,2,0,Kuching City FC,2
09.0414:00,Johor DT,6,0,Kedah,6
09.0414:00,Selangor,3,0,Kelantan,3
09.0414:00,Palau Pinang,4,2,PDRM FC,6
05.0414:00,Kedah,1,0,Palau Pinang,1
05.0414:00,PDRM FC,1,2,Sri Pahang,3
05.0413:15,Kuching City FC,1,1,Kelantan United,2
04.0414:00,Perak,0,5,Johor DT,5
04.0414:00,Selangor,2,1,Negeri Sembilan,3
04.0414:00,Terengganu,5,0,Kelantan,5
01.0414:00,Negeri Sembilan,4,2,Kelantan,6
01.0414:00,Sri Pahang,1,1,Kedah,2
01.0413:15,Kuching City FC,0,1,PDRM FC,1
31.0314:00,Palau Pinang,3,1,Perak,4
31.0314:00,Terengganu,2,1,Kelantan United,3
31.0314:00,Kuala Lumpur City,1,3,Selangor,4
31.0314:00,Johor DT,4,0,Sabah,4
18.0309:30,PDRM FC,2,0,Kelantan United,2
17.0313:00,Selangor,0,4,Johor DT,4
17.0313:00,Kedah,3,0,Kuching City FC,3
17.0312:15,Kelantan,2,2,Kuala Lumpur City,4
17.0312:15,Sabah,5,2,Palau Pinang,7
16.0313:00,Perak,0,3,Sri Pahang,3
16.0312:15,Negeri Sembilan,2,1,Terengganu,3
13.0313:00,Kelantan United,2,3,Kedah,5
12.0313:00,Perak,2,0,Kuching City FC,2
12.0312:15,Sri Pahang,1,1,Sabah,2
12.0309:30,Palau Pinang,1,2,Selangor,3
11.0313:00,Terengganu,1,0,PDRM FC,1
11.0309:30,Johor DT,5,1,Kelantan,6
06.0313:00,Negeri Sembilan,0,7,Johor DT,7
06.0312:15,Kuching City FC,1,2,Sabah,3
05.0313:00,Kelantan,2,0,Palau Pinang,2
05.0313:00,Terengganu,0,0,Kuala Lumpur City,0
05.0309:30,Selangor,1,1,Sri Pahang,2
04.0313:00,Kedah,0,1,PDRM FC,1
04.0309:30,Kelantan United,0,0,Perak,0
02.0313:00,Sri Pahang,4,1,Kelantan,5
02.0312:15,Kuching City FC,0,5,Selangor,5
01.0313:00,Kedah,1,0,Terengganu,1
01.0313:00,Palau Pinang,0,0,Negeri Sembilan,0
01.0312:15,Sabah,3,1,Kelantan United,4
01.0312:15,Kuala Lumpur City,0,3,Johor DT,3
28.0213:00,PDRM FC,0,0,Perak,0
26.0213:00,Negeri Sembilan,1,1,Sri Pahang,2
26.0212:15,Selangor,1,0,Kelantan United,1
25.0213:00,Kuala Lumpur City,2,2,Palau Pinang,4
25.0213:00,Perak,1,4,Kedah,5
25.0211:30,Sabah,4,0,PDRM FC,4
25.0209:30,Kelantan,1,2,Kuching City FC,3
24.0213:00,Johor DT,2,0,Terengganu,2
15.1013:00,Palau Pinang,1,1,Selangor,2
15.1013:00,Sarawak United,1,0,Melaka United,1
15.1013:00,Sri Pahang,2,0,Negeri Sembilan,2
15.1013:00,Kedah,1,3,Terengganu,4
15.1013:00,Johor DT,3,0,Sabah,3
15.1013:00,Petaling Jata City,1,0,Kuala Lumpur City,1
11.1013:00,Kuala Lumpur City,1,2,Terengganu,3
11.1013:00,Petaling Jata City,2,0,Palau Pinang,2
11.1013:00,Johor DT,4,1,Kedah,5
11.1012:15,Negeri Sembilan,2,0,Melaka United,2
11.1012:15,Sri Pahang,1,2,Sabah,3
11.1011:30,Sarawak United,0,1,Selangor,1
08.1012:15,Negeri Sembilan,4,3,Kedah,7
07.1014:15,Sri Pahang,0,0,Johor DT,0
07.1012:15,Petaling Jata City,0,1,Selangor,1
07.1012:15,Melaka United,2,4,Terengganu,6
07.1011:30,Sabah,4,1,Palau Pinang,5
04.1013:00,Kedah,1,3,Johor DT,4
01.1013:00,Selangor,5,0,Melaka United,5
01.1013:00,Kedah,0,1,Petaling Jata City,1
01.1013:00,Terengganu,2,0,Sabah,2
01.1012:15,Sarawak United,1,4,Sri Pahang,5
01.1012:15,Johor DT,5,0,Negeri Sembilan,5
28.0913:00,Kuala Lumpur City,5,0,Sarawak United,5
24.0913:00,Palau Pinang,1,0,Kuala Lumpur City,1
15.0913:00,Melaka United,0,0,Kuala Lumpur City,0
15.0913:00,Petaling Jata City,2,2,Johor DT,4
14.0913:00,Kedah,3,1,Selangor,4
14.0913:00,Terengganu,3,0,Palau Pinang,3
11.0912:15,Sri Pahang,0,2,Kuala Lumpur City,2
10.0911:00,Sabah,2,3,Selangor,5
09.0912:15,Negeri Sembilan,3,2,Sarawak United,5
09.0912:15,Melaka United,0,3,Kedah,3
03.0913:00,Terengganu,5,0,Melaka United,5
03.0912:15,Selangor,1,1,Johor DT,2
02.0913:00,Kedah,1,0,Palau Pinang,1
01.0911:30,Sabah,2,2,Kuala Lumpur City,4
29.0812:15,Johor DT,4,0,Melaka United,4
21.0813:00,Selangor,0,1,Petaling Jata City,1
21.0812:15,Sri Pahang,1,2,Terengganu,3
18.0813:00,Palau Pinang,2,3,Sri Pahang,5
18.0812:15,Kuala Lumpur City,1,0,Negeri Sembilan,1
17.0813:00,Kedah,1,1,Sabah,2
17.0813:00,Selangor,0,2,Terengganu,2
17.0812:15,Sarawak United,0,0,Petaling Jata City,0
13.0813:00,Petaling Jata City,0,2,Negeri Sembilan,2
13.0813:00,Terengganu,1,0,Sarawak United,1
13.0813:00,Melaka United,2,2,Sri Pahang,4
